10,9,10,10,10,10,10,10,10,10
9,9,9,10,12,12,10,10,10,10
10,9,10,10,10,10,10,0,10,12
10,10,10,10,10,10,0,0,0,10
10,10,10,10,10,0,0,0,0,0
10,10,6,10,10,10,1,1,1,10
10,6,6,6,10,10,1,1,1,10
13,13,13,13,13,13,13,13,13,13
13,13,13,13,13,13,13,13,13,13
13,13,13,13,13,13,13,13,13,13
